BF19_HastKar_Baltic_Spring	Baltic_Spring
BF21_HastKar_Baltic_Spring	Baltic_Spring
BM14_HastKar_Baltic_Spring	Baltic_Spring
BM16_HastKar_Baltic_Spring	Baltic_Spring
BM19_HastKar_Baltic_Spring	Baltic_Spring
F1_HastKar_Baltic_Spring	Baltic_Spring
F2_HastKar_Baltic_Spring	Baltic_Spring
F3_HastKar_Baltic_Spring	Baltic_Spring
F4_HastKar_Baltic_Spring	Baltic_Spring
F6_HastKar_Baltic_Spring	Baltic_Spring
HWS41_KandalakshaBay_WhiteSea_Spring	WhiteSea
HWS42_KandalakshaBay_WhiteSea_Spring	WhiteSea
HWS43_KandalakshaBay_WhiteSea_Spring	WhiteSea
HWS44_KandalakshaBay_WhiteSea_Spring	WhiteSea
HWS31_WhiteSea_WhiteSea	WhiteSea
HWS32_WhiteSea_WhiteSea	WhiteSea
HWS33_WhiteSea_WhiteSea	WhiteSea
HWS34_WhiteSea_WhiteSea	WhiteSea
HWS51_KandalakshaBay_WhiteSea_Summer	WhiteSea
HWS52_KandalakshaBay_WhiteSea_Summer	WhiteSea
HWS53_KandalakshaBay_WhiteSea_Summer	WhiteSea
HWS54_KandalakshaBay_WhiteSea_Summer	WhiteSea
Fehmarn3_Fehmarn_Baltic_Autumn	Baltic_Autumn
Fehmarn44_Fehmarn_Baltic_Autumn	Baltic_Autumn
Fehmarn6_Fehmarn_Baltic_Autumn	Baltic_Autumn
Gavle100_Gavle_Baltic_Autumn	Baltic_Autumn
Gavle54_Gavle_Baltic_Autumn	Baltic_Autumn
Gavle98_Gavle_Baltic_Autumn	Baltic_Autumn
